
== Ereignisse ==
22.–25. März Leipziger Buchmesse
10.–14. Oktober Frankfurter Buchmesse, Gastland Katalonien


== Geburts- und Gedenktage ==
3. Februar: 100. Geburtstag von James A. Michener, US-amerikanischer Schriftsteller († 1997)
18. Februar: 200. Geburtstag von Sophie von La Roche, deutsche Schriftstellerin († 1730)
21. Februar: 100. Geburtstag von W. H. Auden, britischer Schriftsteller († 1973)
27. Februar: 400. Geburtstag von Christian Keimann, deutscher Dichter († 1662)
22. April: 300. Geburtstag von Henry Fielding, britischer Schriftsteller († 1754)
18. September: 100. Todestag von Ernest Blum, französischer Schriftsteller (* 1836)
1. November: 100. Todestag von Alfred Jarry, französischer Schriftsteller (* 1873)
1. November: 400. Geburtstag von Georg Philipp Harsdörffer, deutscher Dichter († 1658)
14. November: 100. Geburtstag von Astrid Lindgren, schwedische Schriftstellerin († 2002)


== Neuerscheinungen ==
Belletristik
Amokspiel - Sebastian Fitzek
Am Strand - Ian McEwan
Aurora (Alastair Reynolds) - Alastair Reynolds
Bad Monkeys - Matt Ruff
Beast (Roman) - Ally Kennen
Der dreizehnte Monat - David Mitchell
Ehrensachen - Louis Begley
Das Erlkönig-Manöver - Robert Löhr
Falling Man - Don DeLillo
Flucht zum Mars - Herbert W. Franke
Das Haus – House of Leaves - Mark Z. Danielewski
Harry Potter und die Heiligtümer des Todes - Joanne K. Rowling
Heimweg (Roman) - Harald Martenstein
Horus (Roman) - Wolfgang Hohlbein
Die Hunde und die Wölfe - Irène Némirovsky
Im Garten des Vaters - Jan Siebelink
Der Junge im gestreiften Pyjama - John Boyne
Der Katalane - Noah Gordon
Das Kind von Noah - Éric-Emmanuel Schmitt
Die Kluft - Doris Lessing
Die Lage des Landes - Richard Ford
Der Marsch (Roman) - E. L. Doctorow
Metro 2033 (Roman) - Dmitri Gluchowski
Millionär (Roman) - Tommy Jaud
Die Mittagsfrau - Julia Franck
Mittelmäßiges Heimweh - Wilhelm Genazino
Der Name der Welt - Denis Johnson
Die Offenbarung - Robert Schneider
Das Paradies der Assassinen - Peter Berling
Pazifik Exil - Michael Lentz
Qual (Roman) - Stephen King
Rummelplatz (Roman) - Werner Bräunig
Der Schrecksenmeister - Walter Moers
Slam (Roman) - Nick Hornby
Das Spiel der Könige - Rebecca Gablé
Ein Stammbaum - Patrick Modiano
Die Straße (Roman) - Cormac McCarthy
Touchdown - John Grisham
Waffenwetter - Dietmar Dath
Zwiegespräche mit Gott - Ahne
Sachliteratur
CIA: Die ganze Geschichte - Tim Weiner
Jahrgang 1926/27 – Erinnerungen an die Jahre unter dem Hakenkreuz (Anthologie)
Jazz im New York der wilden Zwanziger - Hans-Jürgen Schaal (Text) und Robert Nippoldt (Illustrationen)
Rufmord und Medienopfer – Hg.: Christian Schertz und Thomas Schuler
Der Tod wird euch finden - Lawrence Wright
Drama
Fegefeuer - Sofi Oksanen


== Gestorben ==
09. Januar - Klaus Poche, deutscher Schriftsteller, Drehbuchautor und Illustrator (* 1927)
11. Januar - Robert Anton Wilson, US-amerikanischer Bestsellerautor (* 1932)
27. Januar - Charles L. Fontenay, amerikanischer Science-Fiction-Autor und Künstler (* 1917)
27. Januar - Iva Hercíková, tschechische Schriftstellerin und Dramaturgin (* 1935)
30. Januar - Sidney Sheldon, US-amerikanischer Schriftsteller und Drehbuchautor (* 1917)
06. Februar - Lee Hoffman, US-amerikanische Autorin von Science-Fiction- und Westernromanen (* 1932)
11. Februar - Marianne Fredriksson, schwedische Schriftstellerin und Journalistin (* 1927)
17. Februar - Jurga Ivanauskaitė, litauische Schriftstellerin (* 1961)
17. Februar - Jakov Lind, österreichisch-englischer Schriftsteller, Hörspielautor, Filmregisseur und Maler (* 1927)
22. Februar - Lothar-Günther Buchheim, deutscher Schriftsteller, Maler, Kunstsammler und Museumsgründer (* 1918)
25. Februar - Jytte Borberg, dänische Schriftstellerin (* 1917)
11. April - Kurt Vonnegut, US-amerikanischer Schriftsteller (* 1922)
08. Juni - Bogomil Rainow, bulgarischer Schriftsteller (* 1919)
27. August - Alberto de Lacerda, portugiesischer Dichter (* 1928)


== Literaturpreise ==


=== Deutsche Literaturpreise ===
Adelbert-von-Chamisso-Preis: Magdalena Sadlon; Que Du Luu und Luo Lingyuan (Förderpreis)
Berliner Literaturpreis: Ilija Trojanow
Brüder-Grimm-Preis der Stadt Hanau: Björn Kern
Carl-Zuckmayer-Medaille: Udo Lindenberg
Clemens-Brentano-Preis: Clemens Meyer, Als wir träumten
Deutscher Buchpreis: Julia Franck, Die Mittagsfrau
Deutscher Science Fiction Preis: Ulrike Nolte: Die fünf Seelen des Ahnen
Ernst-Toller-Preis: Günter Grass
Friedrich-Gundolf-Preis: Nora Iuga
Georg-Büchner-Preis: Martin Mosebach
Heinrich-Mann-Preis: Karl Heinz Bohrer
Hubert-Burda-Preis für junge Lyrik: Nikola Madzirov, Halina Petrosanjak und Eugeniusz Tkaczyszyn-Dycki
Jakob-Wassermann-Preis: Robert Schindel
Johann-Gottfried-Seume-Literaturpreis: Andreas Reimann, ... und Rotwein rauscht an meiner Seele Süden
Johann-Heinrich-Voß-Preis für Übersetzung: Stefan Weidner
Joseph-Breitbach-Preis: F. C. Delius
Leonce-und-Lena-Preis: Christian Schloyer
Kasseler Literaturpreis: F. W. Bernstein; Philipp Tingler (Förderpreis)
Kleist-Preis: Wilhelm Genazino
Mainzer Stadtschreiber: Ilija Trojanow
Mara-Cassens-Preis: Larissa Boehning
Peter-Huchel-Preis: Oswald Egger, Tag und Nacht sind zwei Jahre
Preis der Leipziger Buchmesse:
Ingo Schulze (Belletristik)
Saul Friedländer (Sachbuch/Essayistik)
Swetlana Geier (Übersetzung)

Preis der Literaturhäuser: Sibylle Lewitscharoff
Preis der SWR-Bestenliste: Hans Joachim Schädlich


=== Internationale Literaturpreise ===
Hugo Award

Vernor Vinge, Rainbows End, Kategorie: Bester Roman
Robert Reed, A Billion Eves, Kategorie: Bester Kurzroman
Ian McDonald, The Djinn's Wife, Kategorie: Beste Erzählung
Tim Pratt, Impossible Dreams, Kategorie: Beste Kurzgeschichte

Kurd-Laßwitz-Preis

Herbert W. Franke, Auf der Spur des Engels, Kategorie: Bester Roman
Marcus Hammerschmitt, Canea Null, Kategorie: Beste Kurzgeschichte/Erzählung
Robert Charles Wilson, Spin, Spin, Kategorie: Bestes ausländisches Werk
Volker Oldenburg, Kategorie: Bester Übersetzer
Christian Pree für seine Bibliographie deutschsprachiger Science-Fiction-Stories und Bücher, die zur nicht-kommerziellen Verwendung im Internet zur Verfügung steht, Sonderpreis

Locus Award

Vernor Vinge, Rainbows End, Kategorie: Bester SF-Roman
Ellen Kushner, The Privilege of the Sword, Die Dienerin des Schwertes, Kategorie: Bester Fantasy-Roman
Terry Pratchett, Wintersmith, Der Winterschmied, Kategorie: Bestes Jugendbuch
Naomi Novik, Temeraire: His Majesty's Dragon/Throne of Jade/Black Powder, Drachenbrut/Drachenprinz/Drachenzorn, Kategorie: Bester Erstlingsroman
Charles Stross, Missile Gap, Kategorie: Bester Kurzroman
Cory Doctorow, When Sysadmins Ruled the Earth, Kategorie: Beste Erzählung
Neil Gaiman, How to Talk to Girls at Parties, Kategorie: Beste Kurzgeschichte
Neil Gaiman, Fragile Things, Kategorie: Beste Sammlung
Gardner Dozois, The Year's Best Science Fiction: Twenty-Third Annual Collection, Kategorie: Beste Anthologie

Nebula Award

Michael Chabon, The Yiddish Policemen's Union, Die Vereinigung jiddischer Polizisten, Kategorie: Bester Roman
Nancy Kress, Fountain of Age, Kategorie: Bester Kurzroman
Ted Chiang, The Merchant and the Alchemist's Gate, Der Kaufmann am Portal des Alchemisten, Kategorie: Beste Erzählung
Karen Joy Fowler, Always, Kategorie: Beste Kurzgeschichte
Guillermo del Toro, Pan's Labyrinth, Pans Labyrinth, Kategorie: Bestes Drehbuch

Philip K. Dick Award

M. John Harrison, Nova Swing, Nova

Antonio-Feltrinelli-Preis: Luigi Meneghello
Cervantespreis: Juan Gelman
Danuta Gleed Literary Award: Nathan Sellyn, Indigenous Beasts
Erich-Fried-Preis: Peter Waterhouse
Ethel Wilson Fiction Prize: Carol Windley, Home Schooling
Finlandia-Preis: Hannu Väisänen, Toiset kengät
Ingeborg-Bachmann-Preis: Lutz Seiler
International IMPAC Dublin Literary Award: Pferde stehlen von Per Petterson
Lieutenant Governor’s Award for Literary Excellence: Patrick Lane
Man Booker International Prize: Chinua Achebe
Man Booker Prize for Fiction: Anne Enright für The Gathering
Newbery Medal: Susan Patron, The Higher Power of Lucky
Nobelpreis für Literatur: Doris Lessing
Österreichischer Staatspreis für Europäische Literatur: A. L. Kennedy
Prinz-von-Asturien-Preis für Literatur: Amos Oz
Prix Femina Étranger: Edward St Aubyn, Le goût de la mère
Prix Goncourt: Gilles Leroy, Alabama Song
Pulitzer-Preis:
Roman: The Road von Cormac McCarthy
Sachbuch: The Looming Tower: Al-Qaeda and the Road to 9/11 von Lawrence Wright

Rauriser Literaturpreis: Steffen Popp, Ohrenberg oder der Weg dorthin, Robert Kleindienst (Förderpreis)
Scotiabank Giller Prize: Elizabeth Hay, Late Nights on Air
Trillium Book Award: Barbara Gowdy, Helpless


== Verwandte Preise ==
Friedenspreis des Deutschen Buchhandels: Saul Friedländer
Goethe-Medaille: Dezső Tandori