NOW Big Hits 2004 er et dansk opsamlingsalbum udgivet 15. november 2004 af NOW Music. Albummet er en dobbelt-cd bestående af nogle af de største hits fra 2004.


== Trackliste ==


=== Cd 1 ===
C21: "All That I Want"
Stacie Orrico: "(There's Gotta Be) More To Life"
Outkast: "Hey Ya!"
Dido: "Life For Rent"
Joss Stone: "Super Duper Love (Are You Diggin' On Me?)"
Britney Spears: "Toxic"
L.O.C.: "Undskyld"
P!nk: "God Is A DJ"
Burhan G: "Take U Home"
Evanescence: "My Immortal"
Sugababes: "Too Lost In You"
N*E*R*D: "She Wants To Move"
Eamon: "F**k It (I Don't Want You Back)"
Christine Milton: "Shine On"
Swan Lee: "I Don't Mind"
Christina Aguilera: "The Voice Within"
Thomas Helmig: "Gold Digger"
Juncker: "Mogens & Karen"
Kylie Minogue: "Red Blooded Woman"


=== Cd 2 ===
The Black Eyed Peas: "Shut Up"
Maroon 5: "This Love"
Westlife: "Mandy"
Kelis: "Trick Me"
Maria Mena: "You're The Only One"
Beyoncé: "Naughty Girl"
3 Doors Down: "Here Without You"
Safri Duo feat. Clark Anderson: "All The People In The World"
Nik & Jay: "Pop-Pop!"
Bombay Rockers: "Rock Tha Party"
Avril Lavigne: "Don't Tell Me"
Jokeren: "Det Ku Ha Været Dig"
Anastacia: "Left Outside Alone"
Usher: "Burn"
Tue West: "Hun Er Fri (Kvinden & Lottokuglerne)"
Scissor Sisters: "Take Your Mama"
Frankee: "F.U. Right Back"
Bent Fabric feat. Peter Frödin: "Everytime"
Kanye West: "Through The Wire"